********
*S****E*
* **** *
* **** *
* **** *
*      *
********