********
*S****E*
*X****X*
*XXX**X*
***X**X*
**XX**X*
**X***X*
**XXXXX*
********
