********
*S****E*
* **** *
*   ** *
*** ** *
**  ** *
** *** *
**     *
********